0
######
#Aa@.#
#....#
#....#
#....#
######
