5
######
#.Ba@#
#A...#
#b...#
#@...#
######
