0
######
#Ba@.#
#....#
#....#
#Ab@.#
######
